┌─────────────────────────────────────────────────────────────────────────────────┐   
│                                                                                 │   
│     ┌────IF────────────────────────┐                                            │   
│     │                              │                                            │   
│     │                              │                                            │   
│     │                              │                                            │   
│     │                              ├────────────────────────────────┐           │   
│     │                              │                                │           │   
│     │                              │                                │           │   
│     │                              │                                │           │   
│     │                              │                                │           │   
│     └──────────────────────────────┘                                │           │   
│                                                                     │           │   
│                                                                     │           │   
│         ┌───────────────┐        ┌────────┐                         │           │   
│         │               │        │        │                         │           │   
│         │               │        │        │                         ▼           │   
│         │               │        │        │                   Esto es una       │   
│         └───────────────┘        └────────┘                                     │   
│                                                                                 │   
│                                                                                 │   
└─────────────────────────────────────────────────────────────────────────────────┘   
                                                                                      
                                                                                      
